 #  #  #  #  #  #  #  #  #  #  # 
 #  .  .  .  V  .  #  .  F  .  # 
 #  .  #  #  #  F  #  .  #  .  # 
 #  .  .  .  #  .  .  .  #  P  # 
 #  .  #  .  #  #  #  #  #  .  # 
 #  .  #  F  #  .  .  .  .  .  # 
 #  .  #  .  #  .  #  .  .  .  # 
 #  .  #  .  F  .  .  .  .  .  S 
 E  J  #  #  #  .  #  .  .  .  # 
 #  .  .  .  .  V  .  .  .  .  # 
 #  #  #  #  #  #  #  #  #  #  # 
