 #  #  #  #  #  #  #  #  #  #  # 
 #  .  .  .  .  .  .  .  .  .  # 
 #  .  #  .  #  .  #  #  #  F  # 
 #  .  .  F  #  .  .  .  .  .  S 
 #  .  #  .  #  .  #  .  #  .  # 
 #  .  .  .  .  .  #  .  .  .  # 
 #  .  #  #  #  #  #  .  #  .  # 
 #  .  #  .  .  .  #  F  .  V  # 
 #  #  #  .  #  P  #  .  #  F  # 
 E  J  .  V  .  .  .  .  .  .  # 
 #  #  #  #  #  #  #  #  #  #  # 
