 #  #  #  #  #  #  #  #  #  # 
 #  .  .  .  F  .  .  V  .  # 
 #  #  #  .  #  V  #  .  J  E 
 S  .  #  .  #  .  #  .  #  # 
 #  #  #  .  #  .  #  .  #  # 
 #  .  F  .  #  P  #  .  #  # 
 #  F  #  .  #  #  #  .  #  # 
 #  .  #  .  .  .  .  .  #  # 
 #  #  #  #  #  #  #  #  #  # 
 #  #  #  #  #  #  #  #  #  # 
