 #  #  #  #  #  #  #  #  #  E  # 
 #  .  .  .  .  F  #  .  .  J  # 
 #  .  #  #  #  #  #  .  #  #  # 
 #  .  #  .  .  .  V  .  #  .  # 
 #  .  #  .  #  .  #  .  #  P  # 
 #  .  .  .  .  .  .  .  #  .  # 
 #  .  #  #  #  .  #  .  #  .  # 
 #  .  .  .  #  .  .  .  #  F  # 
 #  .  #  F  #  .  .  .  #  V  # 
 #  .  .  .  .  .  .  .  F  .  # 
 #  #  #  #  #  #  S  #  #  #  # 
