 #  #  #  #  #  #  #  #  #  #  # 
 #  .  .  .  #  .  .  .  .  .  # 
 E  J  #  .  #  V  #  .  #  .  # 
 #  .  .  F  #  .  #  .  .  .  # 
 #  .  #  .  #  #  #  .  .  .  S 
 #  .  #  F  .  .  #  .  .  .  # 
 #  .  #  #  #  F  #  F  #  .  # 
 #  .  .  .  .  .  .  .  #  .  # 
 #  P  #  #  #  #  #  #  #  .  # 
 #  V  .  .  .  .  .  .  .  .  # 
 #  #  #  #  #  #  #  #  #  #  # 
