 #  #  #  #  #  S  #  #  #  # 
 #  .  .  .  .  .  .  F  #  # 
 #  .  #  #  .  .  .  .  #  # 
 #  .  .  V  .  .  .  .  #  # 
 #  #  #  #  #  #  #  .  #  # 
 #  .  .  .  #  .  .  F  #  # 
 #  .  #  .  #  .  #  P  #  # 
 #  .  .  .  .  F  #  V  #  # 
 #  J  #  #  #  #  #  #  #  # 
 #  E  #  #  #  #  #  #  #  # 
