 #  #  #  #  #  #  #  #  S  # 
 #  P  .  .  .  .  #  .  .  # 
 #  .  #  .  #  .  #  F  #  # 
 #  .  #  .  #  .  F  .  #  # 
 #  #  #  .  #  #  #  .  #  # 
 #  .  .  .  #  F  #  .  #  # 
 #  .  #  #  #  .  #  .  #  # 
 #  V  .  .  .  .  .  V  #  # 
 #  #  #  #  J  #  #  #  #  # 
 #  #  #  #  E  #  #  #  #  # 
