 #  #  #  #  #  #  #  #  #  # 
 #  F  F  F  .  F  F  F  #  # 
 #  #  #  .  #  #  #  .  #  # 
 S  .  #  .  .  .  #  V  #  # 
 #  #  #  #  #  #  #  .  #  # 
 #  .  P  .  .  .  F  .  #  # 
 #  .  #  V  #  #  #  .  #  # 
 #  F  #  F  F  .  .  .  J  E 
 #  #  #  #  #  #  #  #  #  # 
 #  #  #  #  #  #  #  #  #  # 
